15 13
XXXXXXXXXXXXX
            X
XXXXXXXXXXX X
X           X
X XXXXXXXXX X
X  X        X
X XXXXXXXXXXX
X X         X
X X X X X X X
X X X X X X X
X X         X
X           X
X XXXXX XXXXX
X            
XXXXXXXXXXXXX

15 13
XXXXXXXXXXXXX
            X
XXXXXXXXXXX X
X           X
X XXXXXXXXX X
X  X        X
X XXXXXXXXXXX
X X         X
X X X X X X X
X X X X X X X
X X XXXXXXX X
X         X X
X XXXXXXXXXXX
X            
XXXXXXXXXXXXX

11 9
XXXXXXXXX
        X
XXXXXXX X
X       X
X XXXXX X
X X     X
X XXXXXXX
X       X
X XXXXXXX
X        
XXXXXXXXX

9 9
XXXXXXXXX
        X
XXXXXXX X
X       X
X XXXXX X
X X     X
X XXXXXXX
X        
XXXXXXXXX

15 15
XXXXXXXXXXXXXXX
  X X X   X X X
X X X X XXX X X
X             X
X XXXXXXXXX X X
X         X X X
XXXXX XXXXXXXXX
X             X
XXX XXXXXXXXX X
X X X       X X
X X X XXXXX X X
X       X   X X
XXXXXXXXX XXXXX
X              
XXXXXXXXXXXXXXX
