15 13
XXXXXXXXXXXXX
            X
XXXXXXXXXXX X
X           X
X XXXXXXXXX X
X  X        X
X XXXXXXXXXXX
X X         X
X X X X X X X
X X X X X X X
X           X
X           X
X XXXXX XXXXX
X            
XXXXXXXXXXXXX